89 90 83 84 12 13 48 49 70 103 89 90 74 75 12 13
91 92 85 86 14 15 71 72 73 103 91 92 76 77 14 15
91 92 85 86 14 15 22 21 23 103 91 92 78 79 14 15
91 92 85 86 14 15 22 21 23 103 91 92 78 79 14 15
93 94 87 88 16 17 22 21 23 103 93 94 80 81 16 17
19 19 19 19 19 19 24 20 25 19 19 19 19 19 19 19
18 18 18 18 18 18 18 18 18 18 18 18 18 18 18 18
19 19 19 19 19 19 19 19 19 19 19 19 19 19 19 19
47 47 47 47 47 47 47 47 47 47 47 47 47 47 47 47
47 47 47 47 47 47 47 47 47 47 47 47 47 47 47 47
47 47 47 47 47 47 47 47 47 47 47 47 47 47 47 47
103 103 103 103 103 103 103 103 103 103 103 103 103 103 103 103







