12 13 12 13 12 13 22 21 23 13 12 13 12 13 12 13
14 15 14 15 14 15 22 21 23 15 14 15 14 15 14 15
14 15 14 15 14 15 22 21 23 15 14 15 14 15 14 15
14 15 14 15 14 15 22 21 23 15 14 15 14 15 14 15
16 17 16 17 16 17 22 21 23 17 16 17 16 17 16 17
19 19 19 19 19 19 24 20 25 19 19 19 19 19 19 19
18 18 18 18 18 18 18 18 18 18 18 18 18 18 18 18
19 19 19 19 19 19 19 19 19 19 19 19 19 19 19 19
12 13 12 13 12 13 12 13 12 13 12 13 12 13 12 13
14 15 14 15 14 15 14 15 14 15 14 15 14 15 14 15
14 15 14 15 14 15 14 15 14 15 14 15 14 15 14 15
14 15 14 15 14 15 14 15 14 15 14 15 14 15 14 15
16 17 16 17 16 17 16 17 16 17 16 17 16 17 16 17
