33 34 27 28 12 13 48 49 70 99 33 34 74 75 12 13
35 36 29 30 14 15 71 72 73 99 35 36 76 77 14 15
35 36 29 30 14 15 22 21 23 99 35 36 78 79 14 15
35 36 29 30 14 15 22 21 23 99 35 36 78 79 14 15
37 38 31 32 16 17 22 21 23 99 37 38 80 81 16 17
19 19 19 19 19 19 24 20 25 19 19 19 19 19 19 19
18 18 18 18 18 18 18 18 18 18 18 18 18 18 18 18
19 19 19 19 19 19 19 19 19 19 19 19 19 19 19 19
47 47 47 47 47 47 47 47 47 47 47 47 47 47 47 47
47 47 47 47 47 47 47 47 47 47 47 47 47 47 47 47
47 47 47 47 47 47 47 47 47 47 47 47 47 47 47 47
99 99 99 99 99 99 99 99 99 99 99 99 99 99 99 99







