1 1 1 1 1 1 1 1 1 1 1 1 1 1 1 1
1 57 0 0 0 0 0 0 0 0 0 0 0 0 57 1
1 0 0 0 0 0 0 0 0 0 0 0 0 0 0 1
1 0 0 0 0 51 0 0 0 50 50 50 50 0 0 1
1 0 0 0 0 0 0 0 0 0 0 0 0 0 0 1
1 0 0 56 56 0 0 0 0 0 0 52 54 52 0 1
1 0 0 0 0 0 0 0 0 0 0 55 52 53 0 1
1 0 0 0 0 0 0 0 0 0 0 53 55 54 0 1
1 0 0 3 3 0 0 0 0 0 0 0 0 0 0 1
1 0 4 2 2 6 0 0 0 0 0 0 0 0 0 1
1 0 0 5 5 0 0 0 0 0 0 0 0 0 0 0
1 0 0 0 0 0 0 0 0 0 0 0 0 0 0 0