9 9 10 9 9 9 9 9 9 301 11 9 8 8 9 9
9 8 8 8 8 8 8 8 8 8 8 8 8 8 8 9 9
9 8 8 300 8 8 8 8 8 8 8 8 8 8 8 9 9
9 8 8 8 8 8 8 8 8 8 8 8 8 8 8 9 9
9 8 8 8 300 8 8 8 300 8 300 8 8 8 8 9 9
9 8 8 8 8 8 8 8 8 8 8 8 8 8 8 9 9
9 8 8 8 8 300 8 8 300 8 8 300 8 8 8 9 9
9 8 8 8 8 8 8 8 8 8 8 8 8 8 8 9 9
9 8 8 8 300 8 8 8 8 8 300 8 8 8 8 9 9
9 8 8 8 8 8 8 8 8 8 8 8 8 8 8 9 9
9 8 8 8 8 8 8 8 300 8 8 8 8 8 8 9 9
9 8 8 8 8 8 8 8 8 8 8 8 8 8 8 9 9