9 9 10 9 9 9 9 9 9 9 11 9 8 8 9
9 8 8 8 8 8 8 8 8 8 8 8 8 8 8 9
9 8 8 8 8 8 8 8 8 8 8 8 8 8 8 9
9 8 8 8 8 8 8 8 8 8 8 8 8 8 8 9
9 8 8 8 8 8 8 8 8 8 8 8 8 8 8 9
9 8 8 8 8 8 8 8 8 8 8 8 8 8 8 9
9 8 8 8 8 8 8 8 8 8 8 8 8 8 8 9
9 8 8 8 8 8 8 8 8 8 8 8 8 8 8 9
9 8 8 8 8 8 8 8 8 8 8 8 8 8 8 9
9 8 8 8 8 8 8 8 8 8 8 8 8 8 8 9
9 8 8 8 8 8 8 8 8 8 8 8 8 8 8 9
9 8 8 8 8 8 8 8 8 8 8 8 8 8 8 9
1 2 3 4 5 6 7 8 9 0 1 2 3 4 5 6