9 9 10 9 9 9 9 9 9 9 9 9 9 9 9 9
9 0 0 0 0 57 0 0 0 0 297 0 0 0 0 0 0
9 0 0 0 0 0 0 0 0 0 0 0 0 0 0 0 0
9 0 0 0 0 0 0 0 0 0 0 0 0 0 3 9 9
9 0 0 297 0 0 0 297 0 297 0 0 0 0 0 9 9
9 0 0 0 0 0 0 0 0 0 0 0 0 0 0 9 9
9 0 0 0 0 0 0 0 0 0 0 0 0 0 5 9 9
9 57 0 0 297 0 0 0 0 0 0 0 0 0 0 9 9
9 0 0 0 0 0 0 0 0 0 0 0 0 0 3 9 9
0 0 0 0 0 0 0 0 0 0 0 0 0 0 0 9 9
0 0 0 0 0 0 0 0 0 0 0 0 0 0 0 9 9
9 0 57 0 0 0 0 57 0 297 0 297 0 0 5 9 9