26 27 27 27 27 27 27 27 27 27 27 27 27 27 27 26
29 30 30 30 30 30 30 30 30 30 30 30 30 30 30 30
29 30 30 30 30 30 30 30 30 30 30 30 30 30 30 30
28 29 29 29 29 29 29 29 29 29 29 29 29 29 29 28
28 29 29 29 29 29 29 29 29 29 29 29 29 29 29 28
28 33 31 31 33 29 29 29 29 29 29 33 31 31 33 28 t
28 36 32 32 36 29 29 29 29 29 29 36 32 32 36 28
28 36 31 31 36 29 29 29 29 29 29 36 31 31 36 28
28 36 32 32 36 29 29 29 29 29 29 36 32 32 36 28
29 29 29 29 29 29 29 29 29 29 29 29 29 29 29 28
29 29 29 29 29 29 29 29 29 29 29 29 29 29 29 28
26 27 27 27 27 27 27 27 27 27 27 27 27 27 27 26