9 9 10 9 9 9 9 9 9 9 9 9 9 9 9 9
9 0 0 0 0 0 0 0 0 0 0 0 0 0 0 0 0
9 0 0 0 0 0 0 0 0 0 0 0 0 0 0 0 0
9 3 0 0 0 0 0 0 0 0 0 0 0 0 3 9 9
9 0 0 0 0 0 0 0 0 0 0 0 0 0 0 9 9
9 0 0 0 0 0 0 0 0 0 0 0 0 0 0 9 9
9 5 0 0 0 0 0 0 0 0 0 0 0 0 5 9 9
9 0 0 0 0 0 0 0 0 0 0 0 0 0 0 9 9
9 0 0 0 0 0 0 0 0 0 0 0 0 0 3 9 9
0 0 0 0 0 0 0 0 0 0 0 0 0 0 0 9 9
0 0 0 0 0 0 0 0 0 0 0 0 0 0 0 9 9
9 0 0 0 0 0 0 0 0 0 0 0 0 0 5 9 9