26 27 27 27 27 27 27 27 27 27 27 27 27 27 27 26
29 29 29 29 29 29 29 29 29 29 29 29 29 29 29 29
28 29 29 29 29 29 29 29 29 29 29 29 29 29 29 28
28 29 29 29 29 29 29 29 29 29 29 29 29 29 29 28
28 29 29 29 29 29 29 29 29 29 29 29 29 29 29 28
28 29 29 29 29 29 29 29 29 29 29 29 29 29 29 28
28 29 29 29 29 29 29 29 29 29 29 29 29 29 29 28
28 29 29 29 29 29 29 29 29 29 29 29 29 29 29 28
28 29 29 29 29 29 29 29 29 29 29 29 29 29 29 28
29 29 29 29 29 29 29 29 29 29 29 29 29 29 29 28
29 29 29 29 29 29 29 29 29 29 29 29 29 29 29 28
26 27 27 27 27 27 27 27 27 27 27 27 27 27 27 26